XXXXXXXXXXXXXXXXXXXXXXXXXXXXXXXXXXXXXXXX
X............X.............~...........X
X............X.............~...........X
X......................~...~.......!...X
X............X.........~...~...........X
X............X.........~...............X
XXXXXXXXXXXXXXXXXXXXXXX~XXXXXXXXXXXXXXXX