XXXXXXXXXXXXXXXXXXXXXXXXXXXXXXXXXXXXXXXXXXXXXXXXXXXXXXXXXXXXXXXXXXXXXXXXXXXXXXXX
X............X.........................X.......................................X
X............X.........................X.......................................X
X......................................X.......................................X
X............X.........................X.......................................X
X............X.........................X.......................................X
XXXXXXXXXXXXXXXXXXXXXXX.XXXXXXXXXXXXXXXX.......................................X
X.....X...........X,,,,,,,,,X..........X.......................................X
X.....X...........X,I,,,,,I,X..........X.......................................X
X.....X..X.....X..X,,,,,,,,,X..........X.......................................X
X.....X..X.....X..X,I,,,,,I,XXXXX..XXXXX.......................................X
X........X.....X...,,,,,,,,,...........X.......................................X
XXXXXXXXXXXX.XXXXXX,I,,,,,I,XXXXX..XXXXX.......................................X
X.................X,,,,,,,,,X..........X.......................................X
X.....~~~~~~~.....X,I,,,,,I,X..........X.......................................X
X.....~~~~~~~.....X,,,,,,,,,X..........X.......................................X
X.....~~~~~~~.....XXXX...XXXXXXXXXXXXXXX.......................................X
X.....~~~~~~~..........................X.......................................X
X.....~~~~~~~.......I.....I............X.......................................X
X.....~~~~~~~..........................X.......................................X
X.....~~~~~~~..........................X.......................................X
X...................I.....I............X.......................................X
X......................................X.......................................X
X......................................X.......................................X
X...................I.....I............X.......................................X
X......................................X.......................................X
XXXXXXXXXXXXXXXXXXXXX.....XXXXXXXXXXXXXX.......................................X
T,,,,,,,T,,,,,,,,,,,,,;;;,,,,,,,,,,,,TTTTTT....................................X
T,,,,,,,,,,,,,,,,,,,I,;;;,I,,,,,,,,,TTTTTTTT...................................X
T,,T,,,,,,,,,,,,,,,,,,;;;,,,,,,,T,,,,,TTT,,,,,,,,,,,,,,,,,,,,,,,;;;,,,,,,,,,,,,X
T,,,,,T,,,,,,T,,T,,,,,;;;,,,,,,,,,,,,,TTTT,,,,,,,,,,,,,,,,,,,,,,;;;,,,,,,,,,,,,T
TT,,T,,,T,,T,,,,T,,,,,;;;,,,,,,,,,,T,,,TTTTTT,,,,,,,,,,,,,,,,,,,;;;,,,,,,,,,,,,T
T,,,,T,,,,,,,,,,,,,,,;;;,,,,,T,,,,,,,,TTTTTT,,,,,,,,,,,,,,,,,,,,,;,,,,,,,,,,,,,T
T,T,,,,,,,,,,,,T,,,,;;;,,,,,,,,,,,~~~~~~~~~~~~~~~~~~~~~~~~~~~,,,,;,,,,~~~,,,,,,T
T,,,,,,;;;;;;;;;;;;;;;,,,,,,,T,,,~~~~~~~~~~~~~~~~~~~~~~~~~~~,,,,,;,,,,~~~~~,,TTT
T,,,,,;;;;;;;;;;;;;;;;,,,,,,,,,,,T~~~~~~~~~~~~~~~~~~~~~~~~~~~~~~,;,,,,,~~~TTTTTT
T,,,,;;;;;;;;;;;;;;;;;,,,,T,,,,,,,T~~~~~~~~~~,,,~~~~~~~~,,,,,,,,;;,,,,,,~~~~TTTT
T,,,;;;,,,,,T,,,,,,,,,,,,,,T,T,T,TT,,T,TTT~~~~~~~~~~~~~~~~,,;;;;;,,,,~~~~~~~TTTT
T,,,,;;,,,,,,,,,,,,,,,,,,,,TT,,,,,,T,T,,T~~~~~~~~~~~~~~~~~~,;,~~~~~~~~~~~~~~~~TT
T,,,,,;;;;;;;;,,,,,,,,,,,,,,,,,,,,,,,,,,,,,~~~~~~,,,,,,,,,,,;,,,,T,,,,~~~~~~TTTT
TTTTTTTT,,,,,;;;;;;;;;;;;;,,,,,,,,,,,,,,,,,,,,,,,,,,;;;;;;;;;,T,,,,,,,,,,,TTTTTT
TTTTTTTTTTTT,,,,,,,,,,,,,;;;;;;;;;;;;;;;;;;;;;;;;;;;;,,,,,,TT,,,,TT,,,,,TTTTTTTT
TTTTTTTTTTTTTTTTTTTTTTTTTTT,,,,,,,,,,,,,,,,,,TTTTTTTTTTTTTTTTTTTTTTTTTTTTTTTTTTT
TTTTTTTTTTTTTTTTTTTTTTTTTTTTTTTTTTTTT,,TTTTTTTTTTTTTTTTTTTTTTTTTTTTTTTTTTTTTTTTT
TTTTTTTTTTTTTTTTTTTTTTTTTTTTTTTTTTTTTTTTTTTTTTTTTTTTTTTTTTTTTTTTTTTTTTTTTTTTTTTT