XXXXXXXXXXXXXXXXXXXXXXXXXXXXXXXXXXXXXXXXXXXXXXXXXXXXXXXXXXXXXXXXXXXXXXXXXXXXXXXX
X............X.........................X.......................................X
X............X.........................X.......................................X
X......................................X.......................................X
X............X.........................X.......................................X
X............X.........................X.......................................X
XXXXXXXXXXXXXXXXXXXXXXX.XXXXXXXXXXXXXXXX.......................................X
X.....X...........X,,,,,,,,,X..........X.......................................X
X.....X...........X,I,,,,,I,X..........XXXXXXXXXXXXXXXXX.XXXXXXXXXXXXXXXXXXXXXXX
X.....X..X.....X..X,,,,,,,,,X..........X............~.......~..................X
X.....X..X.....X..X,I,,,,,I,XXXXX..XXXXX............~.I...I.~..................X
X........X.....X...,,,,,,,,,...........X............~.......~..................X
XXXXXXXXXXXX.XXXXXX,I,,,,,I,XXXXX..XXXXX............~.I...I.~..................X
X.................X,,,,,,,,,X..........X............~.......~..................X
X.....~~~~~~~.....X,I,,,,,I,X..........X............~.I...I.~..................X
X.....~~~~~~~.....X,,,,,,,,,X..........X............~.......~..................X
X.....~~~~~~~.....XXXX...XXXXXXXXXXXXXXX............~~~~.~~~~..................X
X.....~~~~~~~..........................X.......................................X
X.....~~~~~~~.......I.....I............X.......................................X
X.....~~~~~~~..........................XXXXXXXXXXXXXXXXXXXXXXXXXXXXXXXXXX.....XX
X.....~~~~~~~..........................X.......................................X
X...................I.....I............X.......................................X
X......................................X......................XXXXXXX..........X
X......................................X......................X.....X..........X
X...................I.....I............X......................X.....X..........X
X......................................X.......................................X
XXXXXXXXXXXXXXXXXXXXX.....XXXXXXXXXXXXXXXXXXXXXXXXXXXXXXXXXXXXX.....XXXXXXXXXXXX
T,,,,,,,T,,,,,,,,,,,,;;;;;,,,,,,,,,,,TTTTTT,,,,,,,,,,,,,,,,,,,,;;;;;,,,,,,,,,,,T
T,,,,,,,,,,,,,,,,,,,I,;;;,I,,,,,,,,,TTTTTTTT,,,,,,,,,,,,,,,,,,,,;;;,,,,,,,,,,,,T
T,,T,,,,,,,,,,,,,,,,,,;;;,,,,,,,T,,,,,TTT,,,,,,,,,,,,,,,,,,,,,,,;;;,,,,,,,,,,,TT
T,,,,,T,,,,,,T,,T,,,,,;;;,,,,,,,,,,,,,TTTT,,,,,,,,,,,,,,,,,,,,,,;;;,,,,,,,,,,,TT
TT,,T,,,T,,T,,,,T,,,,,;;;,,,,,,,,,,T,,,TTTTTT,,,,,,,,,,,,,,,,,,,;;;,,,,,,,,,,TTT
T,,,,T,,,,,,,,,,,,,,,;;;,,,,,T,,,,,,,,TTTTTT,,,,,,,,,,,,,,,,,,,,,;,,,,,,,,,,,,TT
T,T,,,,,,,,,,,,T,,,,;;;,,,,,,,,,,,~~~~~~~~~~~~~~~~~~~~~~~~~~~,,,,;,,,,~~~,,,,,,T
T,,,,,,;;;;;;;;;;;;;;;,,,,,,,T,,,~~~~~~~~~~~~~~~~~~~~~~~~~~~,,,,,;,,,,~~~~~,,TTT
T,,,,,;;;;;;;;;;;;;;;;,,,,,,,,,,,T~~~~~~~~~~~~~~~~~~~~~~~~~~~~~~,;,,,,,~~~TTTTTT
T,,,,;;;;;;;;;;;;;;;;;,,,,T,,,,,,,T~~~~~~~~~~,,,~~~~~~~~,,,,,,,,;;,,,,,,~~~~TTTT
T,,,;;;,,,,,T,,,,,,,,,,,,,,T,T,T,TT,,T,TTT~~~~~~~~~~~~~~~~,,;;;;;,,,,~~~~~~~TTTT
T,,,,;;,,,,,,,,,,,,,,,,,,,,TT,,,,,,T,T,,T~~~~~~~~~~~~~~~~~~,;,~~~~~~~~~~~~~~~~TT
T,,,,,;;;;;;;;,,,,,,,,,,,,,,,,,,,,,,,,,,,,,~~~~~~,,,,,,,,,,,;,,,,T,,,,~~~~~~TTTT
TT,,,,,,,,,,,;;;;;;;;;;;;;,,,,,,,,,,,,,,,,,,,,,,,,,,;;;;;;;;;,T,,,,,,,,,,,TTTTTT
TTTTTTTT,,,,,,,,,,,,,,,,,;;;;;;;;;;;;;;;;;;;;;;;;;;;;,,,,,,TT,,,,TT,,,,,TTTTTTTT
TTTTTTTTTT,T,,,,,,,,,,,,,,,,,,,,,,,,,,,,,,,,,,,,,,,,,,,,,,,,,,,TTTTTTTT,TTTTTTTT
TTTTTTTTTTTTTTTTTTT,,,,,,TTTT,,,,,,,,,,,,,,,TTTTTT,,,,,,,,,,,TTTTTTTTTTTTTTTTTTT
TTTTT,TTTTTTTTTTTTTTTTTTTTTTTTTTTT,,,,TTTTTTTTTTTTTTTTT,TTTTTTTTTTTTTTTTTTTTTTTT
TTTTTTTTTTTT,TTTTTTTTTTTTTTTTTTTTTTTTTTTTTTTT,TTTTTTTTTTTTTTTTTTTTTTTTTTTTTTTTTT
TTTTTTTTTTTTTTTTTTTTTTTTTTTTTTTTTTTTTTTTTTTTTTTTTTTTTTTTTTTTTTTTTTTTTTTTTTTTTTTT