XXXXXXXXXXXXXXXXXXXXXXXXXXXXXXXXXXXXXXXXX
X................X......................X
X...........XXXXXX...............XXXXXXXX
X.....XXXX.XX....X...............X......X
X.....X..........X......................X
XXXXXXX..........X...............X......X
X.....XXXXXXX.XXXX.........XXXXXXX......X
X.....X..........X.........X............X
X.....X..........X.........X............X
X.....XXXX.XXXXXXXXXXXXXXXXX............X
X.....X.................................X
X.....XXXXXXXXXXXXXXXXXXXXXXXXXXXXXXX..XX
X.......................................X
X...........XXXXX.......................X
XXXXXXXXXXXXX...X..........XXXX...XXXXXXX
X...........X...X..........X............X
X...........XXX.X..........X............X
X..........................X............X
X..........................X............X
XXXXXXXXXXXXXXXXXXXXXXXXXXXXXXXXXXXXXXXXX