XXXXXXXXXXXXXXXXXXXXXXXXXXXXXXXXXXXXXXXXXXXXXXXXXXXXXXXXXXXXXXXXXXXXXXXXXXXXXXXX
X............X.........................X.......................................X
X............X.........................X................................!......X
X......................................X.......................................X
X............X.........................X.......................................X
X............X.........................X.......................................X
XXXXXXXXXXXXXXXXXXXXXXX.XXXXXXXXXXXXXXXX.......................................X
X.....X...........X,,,,,,,,,X..........X.......................................X
X.....X...........X,G,,,,,G,X..........XXXXXXXXXXXXXXXXXdXXXXXXXXXXXXXXXXXXXXXXX
X..l..X..X.....X..X,,,,,,,,,X..........Xl...........~.......~...X..............X
X.....X..X.....X..X,G,,,,,G,XXXXX..XXXXX............~.I...I.~...X..............X
X........X.....X...,,,,,,,,,...........X............~.......~..................X
XXXXXXXXXXXX.XXXXXX,G,,,,,G,XXXXX..XXXXX............~.I...I.~..................X
X.................X,,,,,,,,,X..........X............~.......~...X..............X
X.....~~~~~~~.....X,G,,,,,G,X..........X............~.I...I.~...X..............X
X.....~~~~~~~.....X,,,,,,,,,X..........X............~.......~...X..............X
X.....~~~~~~~.....XXXX...XXXXXXXXXXXXXXX............~~~~.~~~~...X..............X
X.....~~~~~~~.....X....................X........................X..............X
X.....~~~~~~~.....X.I.....I............X........................X..............X
X.....~~~~~~~.....X....................XXXXXXXXXXXXXXXXXXXXXXXXXXXXXXXXXX.....XX
X.....~~~~~~~.....X....................X.......................................X
X.................X.I.....I............X.......................................X
X......................................X......................XXXXXXX..........X
X.................X....................X......................X.....X..........X
X.................X.I.....I............X......................X.....X..........X
X.................X....................X.......................................X
XXXXXXXXXXXXXXXXXXXXXdddddXXXXXXXXXXXXXXXXXXXXXXXXXXXXXXXXXXXXXdddddXXXXXXXXXXXX
T,,,,,,,T,,,,,,,,,,,,;;;;;,,,,,,,,,,,TTTTTT,,,,,,,,,,,,,,,,,,,,;;;;;,,,,,,,,,,,T
T,,,,,,,,,,,,,,,,,,,G,;;;,G,,,,,,,,,TTTTTTTT,,,,,,,,,,,,,,,,,,,,;;;,,,,,,,,,,,,T
T,,T,,,,,,,,,,,,,,,,,,;;;,,,,,,,T,,,,,TTT,,,,,,,,,,,,,,,,,,,,,,,;;;,,,,,,,,,,,TT
T,,,,,T,,,,,,T,,T,,,,,;;;,,,,,,,,,,,,,TTTT,,,,,,,,,,,,,,,,,,,,,,;;;,,,,,,,,,,,TT
TT,,T,,,T,,T,,,,T,,,,,;;;,,,,,,,,,,T,,,TTTTTT,,,,,,,,,,,,,,,,,,,;;;,,,,,,,,,,TTT
T,,,,T,,,,,,,,,,,,,,,;;;,,,,,T,,,,,,,,TTTTTT,,,,,,,,,,,,,,,,,,,,,;,,,,,,,,,,,,TT
T,T,,,,,,,,,,,,T,,,,;;;,,,,,,,,,,,~~~~~~~~~~~~~~~~~~~~~~~~~~~,,,,;,,,,~~~,,,,,,T
T,,,,,,;;;;;;;;;;;;;;;,,,,,,,T,,,~~~~~~~~~~~~~~~~~~~~~~~~~~~,,,,,;,,,,~~~~~,,TTT
T,,,,,;;;;;;;;;;;;;;;;,,,,,,,,,,,T~~~~~~~~~~~~~~~~~~~~~~~~~~~~~~,;,,,,,~~~TTTTTT
T,,,,;;;;;;;;;;;;;;;;;,,,,T,,,,,,,T~~~~~~~~~~,,,~~~~~~~~,,,,,,,,;;,,,,,,~~~~TTTT
T,,,;;;,,,,,T,,,,,,,,,,,,,,T,T,T,TT,,T,TTT~~~~~~~~~~~~~~~~,,;;;;;,,,,~~~~~~~TTTT
T,,,,;;,,,,,,,,,,,,,,,,,,,,TT,,,,,,T,T,,T~~~~~~~~~~~~~~~~~~,;,~~~~~~~~~~~~~~~~TT
T,,,,,;;;;;;;;,,,,,,,,,,,,,,,,,,,,,,,,,,,,,~~~~~~,,,,,,,,,,,;,,,,T,,,l~~~~~~TTTT
TT,,,,,,,,,,,;;;;;;;;;;;;;,,,,,,,,,,,,,,,,,,,,,,,,,,;;;;;;;;;,T,,,,,,,,,,,TTTTTT
TTTTTTTT,,,,,,,,,,,,,,,,,;;;;;;;;;;;;;;;;;;;;;;;;;;;;,,,,,,TT,,,,TT,,,,,TTTTTTTT
TTTTTTTTTT,T,,,,,,,,,,,,,,,,,,,,,,,,,,,,,,,,,,,,,,,,,,,,,,,,,,,TTTTTTTT,TTTTTTTT
TTTTTTTTTTTTTTTTTTT,,,,,,TTTT,,,,,,,,,,,,,,,TTTTTT,,,,,,,,,,,TTTTTTTTTTTTTTTTTTT
TTTTT,TTTTTTTTTTTTTTTTTTTTTTTTTTTT,,,,TTTTTTTTTTTTTTTTT,TTTTTTTTTTTTTTTTTTTTTTTT
TTTTTTTTTTTT,TTTTTTTTTTTTTTTTTTTTTTTTTTTTTTTT,TTTTTTTTTTTTTTTTTTTTTTTTTTTTTTTTTT
TTTTTTTTTTTTTTTTTTTTTTTTTTTTTTTTTTTTTTTTTTTTTTTTTTTTTTTTTTTTTTTTTTTTTTTTTTTTTTTT