XXXXXXXXXXXXXXXXXXXXXXXXXXXXXXXXXXXXXXXXX
X................X......................X
X..@........XXXXXX.....S.........XXXXXXXX
X....sXXXX.XX..w.X...............X......X
X.....X.S.....S..X......S...............X
XXXXXXX..........X...............X......X
X.....XXXXXXX.XXXX...S.....XXXXXXX......X
X.....X........S.X.........X............X
X.....X..........X.........X............X
X.....XXXX.XXXXXXXXXXXXXXXXX.....S......X
X.....X.................................X
X.....XXXXXXXXXXXXXXXXXXXXXXXXXXXXXXX..XX
X.......................................X
X...........XXXXX.......S...............X
XXXXXXXXXXXXX.p.X..........XXXX...XXXXXXX
X...S.......X...X..........X............X
X...........XXX.X..........X............X
Xi.......S.................X............X
X..........................X..r.........X
XXXXXXXXXXXXXXXXXXXXXXXXXXXXXXXXXXXXXXXXX