XXXXXXXXXXXXXXXXXXXXXXXXXXXXXXXXXXXXXXXXX
X.................
X...........XXXXXX
X.....XXXX.XX....X
X.....X
X
X
X
X
X
X
X
X
X..............................
X..........................XXXX...XXXXXXX
X..........................X............X
X..........................X............X
X..........................X............X
X..........................X............X
XXXXXXXXXXXXXXXXXXXXXXXXXXXXXXXXXXXXXXXXX